#### FOLD 0 ####
file name 	 gold label 	 predicted label
TAM_MSA_01	POSITIVE		POSITIVE
TAM_MSA_02	POSITIVE		POSITIVE
TAM_MSA_03	POSITIVE		POSITIVE
TAM_MSA_04	HIGHLY POSITIVE		POSITIVE
TAM_MSA_05	NEUTRAL		POSITIVE
TAM_MSA_06	POSITIVE		POSITIVE
TAM_MSA_08	POSITIVE		POSITIVE
TAM_MSA_10	POSITIVE		POSITIVE
TAM_MSA_11	POSITIVE		POSITIVE
TAM_MSA_12	POSITIVE		POSITIVE
TAM_MSA_13	POSITIVE		POSITIVE
TAM_MSA_15	NEUTRAL		POSITIVE
TAM_MSA_17	HIGHLY NEGATIVE		POSITIVE
TAM_MSA_27	NEGATIVE		POSITIVE
#### END FOLD 0 ####

#### FOLD 1 ####
file name 	 gold label 	 predicted label
TAM_MSA_07	HIGHLY POSITIVE		POSITIVE
TAM_MSA_09	HIGHLY POSITIVE		POSITIVE
TAM_MSA_14	POSITIVE		POSITIVE
TAM_MSA_16	NEUTRAL		POSITIVE
TAM_MSA_18	POSITIVE		POSITIVE
TAM_MSA_19	POSITIVE		POSITIVE
TAM_MSA_20	POSITIVE		POSITIVE
TAM_MSA_21	POSITIVE		POSITIVE
TAM_MSA_22	POSITIVE		POSITIVE
TAM_MSA_23	NEUTRAL		POSITIVE
TAM_MSA_24	POSITIVE		POSITIVE
TAM_MSA_25	HIGHLY NEGATIVE		POSITIVE
TAM_MSA_26	POSITIVE		POSITIVE
TAM_MSA_28	NEGATIVE		POSITIVE
#### END FOLD 1 ####

#### FOLD 2 ####
file name 	 gold label 	 predicted label
TAM_MSA_29	POSITIVE		POSITIVE
TAM_MSA_30	POSITIVE		POSITIVE
TAM_MSA_31	POSITIVE		POSITIVE
TAM_MSA_32	HIGHLY POSITIVE		POSITIVE
TAM_MSA_33	POSITIVE		POSITIVE
TAM_MSA_34	HIGHLY NEGATIVE		POSITIVE
TAM_MSA_35	POSITIVE		POSITIVE
TAM_MSA_36	NEGATIVE		POSITIVE
TAM_MSA_37	POSITIVE		POSITIVE
TAM_MSA_38	POSITIVE		POSITIVE
TAM_MSA_39	POSITIVE		POSITIVE
TAM_MSA_40	HIGHLY POSITIVE		POSITIVE
TAM_MSA_45	NEUTRAL		POSITIVE
#### END FOLD 2 ####

#### FOLD 3 ####
file name 	 gold label 	 predicted label
TAM_MSA_41	POSITIVE		POSITIVE
TAM_MSA_42	POSITIVE		POSITIVE
TAM_MSA_43	POSITIVE		POSITIVE
TAM_MSA_44	POSITIVE		POSITIVE
TAM_MSA_46	NEUTRAL		POSITIVE
TAM_MSA_47	NEGATIVE		POSITIVE
TAM_MSA_48	POSITIVE		POSITIVE
TAM_MSA_49	HIGHLY NEGATIVE		POSITIVE
TAM_MSA_50	HIGHLY POSITIVE		POSITIVE
TAM_MSA_51	POSITIVE		POSITIVE
TAM_MSA_52	POSITIVE		POSITIVE
TAM_MSA_53	HIGHLY POSITIVE		POSITIVE
TAM_MSA_54	POSITIVE		POSITIVE
#### END FOLD 3 ####

